1111111111111111111111111111111111
1.1                              1
1 11      1111          111p     1
1  1    1111111111111      111   1
11 1       111              11   1
1  1                             1
1         1111        111111  1111
11111                      1     1
1      1111111             1     1
1                          11    1
11     1111111111111111111       1
1   1                        1  .1
1111111111111111111111111111111111